E	E	E	E	E	S	E	E	E	E	E	E	E	S	E	E	E	E	E	E	E	E	E	E
E	E	E	E	E	E	E	E	E	E	E	E	E	E	E	E	E	E	E	E	E	E	E	E
E	E	E	E	E	E	E	E	E	E	E	E	E	E	E	E	E	E	E	E	E	E	E	E
E	E	E	E	E	E	E	E	E	E	E	E	E	E	E	E	E	E	E	E	E	E	E	E
E	O	O	E	E	O	O	E	E	O	O	E	E	O	O	E	E	O	O	E	E	O	O	E
E	O	O	E	E	O	O	E	E	O	O	E	E	O	O	E	E	F	O	E	E	O	O	E
E	O	O	E	E	O	O	E	E	O	O	E	E	O	O	E	E	O	O	E	E	O	O	E
E	O	O	E	E	E	E	E	E	O	O	E	E	O	O	E	E	O	O	E	E	O	O	E
E	E	E	E	E	E	E	E	E	E	E	E	E	E	E	E	E	E	E	E	E	E	E	E
E	E	E	E	E	E	E	E	E	E	E	E	E	E	E	E	E	E	E	E	E	E	E	E
E	E	E	E	E	E	E	E	E	E	E	E	E	E	E	E	E	E	E	E	E	E	E	E
E	E	E	E	E	E	E	E	E	E	E	E	E	E	E	E	E	E	E	E	E	E	E	E
E	E	E	E	E	E	E	E	E	E	E	E	E	E	E	E	E	E	E	E	E	E	E	E
S	E	E	E	E	E	E	E	E	E	E	E	E	E	E	E	E	E	E	E	E	E	E	E
E	E	E	E	E	E	E	E	E	E	E	E	E	E	E	E	E	E	E	E	E	E	E	E
E	E	E	E	E	E	E	E	E	E	E	E	E	E	E	E	E	E	E	E	E	E	E	E
E	O	O	E	E	O	O	E	E	O	O	E	E	O	O	E	E	O	O	E	E	O	O	E
E	O	O	E	E	O	O	E	E	O	O	E	E	F	O	E	E	O	O	E	E	O	O	E
E	O	O	E	E	O	O	E	E	O	O	E	E	O	O	E	E	O	O	E	E	O	O	E
E	O	F	E	E	O	O	E	E	O	O	E	E	O	O	E	E	O	F	E	E	O	O	E
E	E	E	E	E	E	E	E	E	E	E	E	E	E	E	E	E	E	E	E	E	E	E	E
E	E	E	E	E	E	E	E	E	E	E	E	E	E	E	E	E	E	E	E	E	E	E	E
E	E	E	E	E	E	E	E	E	E	E	E	E	E	E	E	E	E	E	E	E	E	E	E
E	E	E	S	E	E	E	E	E	E	E	E	E	E	E	E	E	E	E	E	E	E	E	E
