O	E	E	E	O	E	E	O	O	E	O	O	E	O	E	O	E	E	O	O	O	E	E	E
O	O	O	E	O	O	E	O	E	E	E	E	E	E	O	O	O	O	O	E	E	O	O	E
O	E	E	E	O	E	O	E	O	E	O	O	E	O	E	E	O	E	E	E	O	O	S	E
O	O	O	E	O	E	F	E	E	E	E	E	O	O	O	E	O	O	O	E	E	E	O	O
E	O	O	O	E	E	E	O	E	E	O	E	E	E	E	E	O	E	E	E	E	O	E	O
E	E	E	E	E	E	O	E	E	O	E	O	O	E	O	E	E	E	E	E	E	E	O	E
E	O	O	O	E	O	O	O	O	E	E	O	O	E	F	E	O	E	E	E	E	O	E	E
O	O	E	O	E	E	O	E	O	O	E	O	O	E	E	E	O	O	E	E	E	E	O	E
O	E	E	E	O	E	E	E	E	E	F	O	E	E	O	E	O	E	O	E	E	O	O	O
E	F	O	E	O	E	O	E	E	E	O	E	O	E	E	O	E	O	E	O	E	O	O	O
E	O	O	O	E	E	E	O	O	E	O	E	O	O	E	O	E	E	E	E	E	E	O	E
O	E	E	O	O	E	E	E	E	O	O	O	E	E	O	O	O	E	O	O	E	O	O	O
E	O	E	O	E	S	O	E	E	O	O	E	O	O	O	O	E	E	E	O	E	E	E	O
E	O	O	E	E	E	O	O	O	E	E	E	O	O	E	E	E	E	E	E	E	O	O	E
E	O	O	O	E	E	E	O	O	O	O	E	E	O	O	E	O	E	E	O	E	O	E	E
E	E	S	O	O	O	O	E	E	E	E	E	E	O	E	O	E	E	E	E	E	E	E	E
E	E	E	O	E	O	E	E	E	E	E	O	O	O	E	E	E	O	E	E	E	E	E	E
E	E	E	E	E	E	E	O	O	O	O	E	O	O	E	E	E	E	E	O	O	O	E	E
E	E	O	F	O	O	E	E	E	E	E	E	E	E	E	E	O	E	E	S	O	O	E	E
E	E	E	O	E	E	E	E	O	E	O	E	E	E	O	O	O	E	O	E	E	O	E	O
E	E	O	E	E	O	O	E	E	E	E	E	O	O	E	O	E	O	O	O	E	E	E	E
O	E	E	E	O	O	S	O	F	O	E	O	O	E	O	O	O	E	E	E	S	E	E	O
E	E	O	E	E	E	O	O	E	E	E	E	O	E	E	O	E	O	O	O	E	E	O	E
E	O	E	E	E	E	E	E	E	E	E	O	E	O	E	E	E	O	E	E	O	O	O	E
